#######
#     #
#     #
# $$. #
#. #$ #
#+$ . #
#######