########
#   #  #
#   #@ #
#     .#
#   #$ #
#   #  #
########