########
#   #  #
#   #@ #
#    *.#
#   #$ #
#   #  #
########