#########
#       #
# # $ $ #
#   $   #
#    #  #
## #### #
#  ..   #
# +     #
#########